11 11 11 11 11 11 11 11 11 11 11 11 11 11 11 11 11 11 11 11 11 11 11 11 11 11 11 11 11 11 11 11 11 11 11 11 11 11 11 11 11 11 11 11 11 11 11 11 11 11
11 11 11 11 11 11 11 11 11 11 11 11 11 11 12 11 11 11 11 11 11 11 11 11 11 11 11 11 11 11 11 11 11 11 11 11 11 11 11 11 11 11 11 11 11 11 11 11 11 11
11 11 11 11 11 11 11 12 11 11 11 11 11 11 11 11 11 11 11 11 11 11 11 11 11 12 11 11 11 11 11 11 11 12 11 11 11 11 11 11 11 11 11 11 11 11 11 11 11 11
11 11 11 11 12 11 11 11 11 11 11 12 11 11 11 11 11 11 12 11 11 11 11 11 11 11 11 12 11 11 11 11 11 11 11 11 11 11 11 11 11 12 11 11 11 11 11 11 11 11
11 11 11 11 11 11 11 11 11 12 11 11 11 11 11 12 11 11 11 11 11 11 11 12 11 11 11 11 11 11 11 12 11 11 12 11 11 11 12 11 11 11 11 11 11 11 11 11 11 11
11 11 11 11 11 11 11 11 11 11 11 11 11 11 11 11 11 11 11 11 11 12 11 11 11 11 11 11 11 12 11 11 11 11 11 11 12 11 11 11 11 11 11 12 11 11 11 11 11 11
11 11 11 11 11 12 21 19 19 19 19 19 19 19 22 11 11 11 21 19 19 19 19 19 19 19 19 22 11 11 11 21 19 19 19 19 19 19 19 19 19 19 22 11 11 11 11 11 11 11
11 11 11 11 11 11 17 40 39 39 39 39 39 40 18 19 19 19 20 40 10 10 10 10 10 10 10 18 19 19 19 20 40 10 34 32 32 32 32 32 32 35 16 11 11 12 11 11 11 11
11 11 12 11 11 11 17 40 39 38 38 38 39 40 40 40 40 40 40 40 10 13 14 14 14 15 10 40 40 40 40 40 40 40 30 25 25 25 25 25 25 29 16 11 11 11 11 11 11 11
11 11 11 11 11 11 17 40 39 38 44 38 39 40 40 40 40 40 40 40 10 16 11 11 11 17 10 40 40 40 40 40 40 40 30 25 25 25 25 25 25 29 16 11 11 11 11 11 11 11
11 11 11 12 11 11 17 40 39 38 38 38 39 40 40 40 40 40 40 40 10 16 11 11 11 17 10 40 40 40 40 40 40 40 30 25 25 25 25 25 25 29 16 11 12 11 11 11 11 11
11 11 11 11 12 11 17 40 39 38 38 38 39 40 40 40 40 40 40 40 10 18 19 19 19 20 10 40 40 40 40 40 40 40 30 25 25 25 25 25 25 29 16 11 11 11 11 11 11 11
11 11 11 11 11 11 17 40 39 39 38 39 39 40 40 40 40 40 40 40 10 10 34 32 35 10 10 10 10 10 10 10 10 10 36 27 27 28 25 26 27 37 16 12 11 11 11 11 11 11
11 11 11 11 11 11 17 40 40 40 10 40 40 40 40 40 40 40 40 40 40 40 30 25 29 40 40 40 40 40 40 40 40 40 40 40 40 30 25 29 13 14 24 11 11 11 11 11 11 11
11 11 11 11 12 11 17 40 40 40 10 40 40 40 40 40 40 40 40 40 40 40 30 25 29 40 40 40 40 40 40 40 40 40 40 40 40 30 25 29 16 11 11 11 11 12 11 11 11 11
11 11 11 11 11 11 23 14 15 40 10 40 40 40 40 40 40 40 40 40 40 40 30 25 29 40 40 40 40 40 40 40 40 40 40 40 40 30 25 29 16 11 11 11 11 11 11 11 11 11
11 11 11 11 11 11 11 11 17 40 10 40 40 40 40 40 40 40 40 40 40 40 30 25 29 10 10 10 40 40 40 40 40 40 40 40 40 30 25 29 16 11 11 11 11 11 12 11 11 11
11 11 12 11 11 11 11 21 20 40 10 40 40 40 40 40 40 40 40 40 40 40 30 25 29 40 40 40 40 40 40 40 40 40 40 34 32 33 25 29 16 11 11 12 11 11 11 11 11 11
11 11 11 11 11 11 11 17 10 10 10 40 40 40 40 40 40 40 40 40 40 40 30 25 29 40 40 40 40 40 40 40 40 40 40 30 25 25 25 29 16 11 11 11 11 11 11 11 11 11
11 11 11 12 11 11 11 17 10 40 40 40 40 40 40 40 40 40 40 40 40 34 33 25 31 35 40 40 40 40 40 40 40 40 40 30 25 26 27 37 16 11 12 11 11 11 11 11 11 11
11 11 11 11 11 11 11 17 10 40 40 40 10 34 32 32 32 32 32 32 32 33 25 25 25 31 32 32 32 32 32 32 32 32 32 33 25 29 10 40 16 11 11 11 11 11 11 11 11 11
11 11 11 11 11 12 11 17 10 40 40 40 10 30 25 25 25 25 25 25 25 25 25 25 25 25 25 25 25 25 25 25 25 25 25 25 25 29 10 13 24 11 11 11 11 11 11 11 11 11
11 11 11 11 11 11 12 17 10 10 40 40 10 36 27 27 27 27 27 27 27 28 25 25 25 26 27 27 27 27 27 27 27 27 27 28 25 29 10 16 11 12 11 11 11 11 11 11 11 11
11 11 11 11 11 11 11 23 15 10 40 40 10 40 40 40 40 40 40 40 40 36 28 25 26 37 40 40 40 40 40 40 40 40 40 30 25 29 10 16 11 11 11 11 12 11 11 11 11 11
11 11 11 11 11 11 11 11 17 10 40 40 10 40 40 40 40 40 40 40 40 40 30 25 29 40 40 40 40 40 40 40 40 40 40 30 25 29 10 16 11 11 11 11 11 11 11 11 11 11
11 11 11 11 11 12 11 21 20 10 40 40 10 10 10 40 40 40 40 40 40 40 30 25 29 40 40 40 40 40 40 40 40 40 40 30 25 29 10 16 11 11 11 12 11 11 11 11 11 11
11 11 11 11 11 11 11 17 10 10 40 40 40 40 10 40 40 40 40 40 40 40 30 25 29 40 40 40 40 40 40 40 40 40 40 30 25 29 10 16 11 11 11 11 11 11 11 11 11 11
11 11 11 12 11 11 11 17 10 40 40 40 40 40 10 40 40 40 40 40 40 40 30 25 29 10 10 10 10 40 40 40 40 40 40 30 25 29 10 16 11 12 11 11 11 11 11 11 11 11
11 11 11 11 11 11 11 17 10 40 40 40 40 40 10 40 40 40 40 40 40 40 30 25 29 40 40 40 10 40 10 40 40 40 40 30 25 29 10 16 11 11 11 11 11 11 11 11 11 11
11 11 11 11 11 11 12 17 10 10 10 10 10 10 10 40 40 40 40 40 40 40 30 25 29 40 40 40 10 40 10 40 40 40 40 36 27 37 10 16 11 11 11 11 12 11 11 11 11 11
11 11 11 11 11 11 11 17 10 10 10 10 10 10 10 40 40 40 40 40 40 40 30 25 29 40 40 40 10 10 10 40 40 40 40 40 10 40 13 24 11 11 12 11 11 11 11 11 11 11
11 11 11 11 11 11 11 23 15 10 10 10 10 10 10 40 40 40 40 40 40 40 30 25 29 40 40 40 40 40 40 40 40 40 40 10 10 10 16 11 11 11 11 11 11 11 11 11 11 11
11 11 11 11 11 12 11 11 17 10 10 10 10 10 10 40 40 40 40 40 40 40 30 25 29 40 40 40 40 40 40 40 40 40 40 10 10 10 16 11 11 11 11 11 11 11 12 11 11 11
11 11 11 11 11 11 11 11 17 10 10 10 10 10 10 40 40 40 40 40 40 40 30 25 29 40 40 40 40 40 40 40 40 40 40 10 10 10 16 11 11 12 11 11 11 11 11 11 11 11
11 11 11 11 11 11 11 11 17 10 10 10 10 10 10 40 40 40 40 40 40 40 30 25 29 40 40 40 40 40 40 40 40 40 40 10 10 10 16 11 11 11 11 11 11 11 11 11 11 11
11 11 11 11 12 11 11 21 20 40 40 40 40 40 40 40 40 40 40 40 40 40 36 27 37 40 40 40 40 40 40 40 40 40 40 10 10 10 18 22 11 11 11 11 11 11 11 11 11 11
11 11 11 11 11 11 11 17 40 40 40 40 40 40 40 40 40 40 40 10 10 10 10 10 10 10 10 40 40 40 40 40 40 40 10 10 10 10 10 18 22 11 11 11 12 11 11 11 11 11
11 11 11 11 11 11 12 17 40 40 40 40 40 40 40 40 40 40 10 10 10 10 10 10 10 10 10 10 40 40 10 40 40 10 10 10 10 10 10 10 16 11 11 11 11 11 11 11 11 11
11 11 11 11 11 11 11 17 10 40 40 40 40 40 40 40 40 40 10 10 10 10 10 10 10 10 10 10 40 40 40 40 10 10 10 10 10 10 10 10 16 11 12 11 11 11 11 11 11 11
11 11 11 11 11 11 11 17 10 40 41 40 40 10 40 40 40 40 10 10 10 10 10 10 10 10 10 10 10 40 40 40 10 10 10 10 10 40 10 10 16 11 11 11 11 11 11 11 11 11
11 11 12 11 11 11 11 17 10 10 10 40 10 10 10 10 10 10 10 10 10 10 10 10 10 10 10 10 10 10 10 10 10 10 40 10 10 10 10 10 16 11 11 11 11 12 11 11 11 11
11 11 11 11 11 11 11 17 10 10 10 10 10 10 40 40 40 40 40 10 10 10 10 10 10 10 10 13 14 14 15 10 10 10 10 10 10 10 10 10 16 11 11 11 11 11 11 12 11 11
11 11 11 11 11 11 11 17 40 40 40 40 40 40 40 40 40 40 40 10 10 10 10 10 10 10 13 24 11 11 17 10 10 40 10 10 40 10 10 10 16 11 11 11 11 11 11 11 11 11
11 11 11 11 12 11 11 23 14 14 14 14 14 14 14 14 14 14 14 14 14 14 14 14 14 14 24 11 12 11 23 15 10 10 10 10 10 10 13 14 24 11 12 11 11 11 11 11 11 11
11 11 11 11 11 11 11 11 11 11 11 11 11 11 11 11 11 11 12 11 11 11 11 11 11 11 11 11 11 11 11 23 14 14 14 14 14 14 24 11 11 11 11 11 11 11 12 11 11 11
11 11 11 11 11 11 11 11 11 11 11 12 11 11 11 11 12 11 11 11 11 11 11 11 11 11 11 11 11 11 11 11 11 11 11 11 12 11 11 11 11 11 11 12 11 11 11 11 11 11
11 11 11 11 11 11 12 11 11 11 11 11 11 11 11 11 11 11 11 11 11 11 11 11 12 11 11 11 11 12 11 11 11 11 11 11 11 11 11 11 11 11 11 11 11 11 11 11 11 11
11 11 11 11 11 11 11 11 11 11 11 11 11 11 12 11 11 11 11 11 12 11 11 11 11 11 11 11 11 11 11 11 12 11 11 11 11 11 11 12 11 11 11 11 11 11 11 11 11 11
11 11 11 11 11 11 11 11 11 11 11 11 11 11 11 11 11 11 11 11 11 11 11 11 11 11 11 12 11 11 11 11 11 11 11 11 11 11 11 11 11 11 11 11 11 12 11 11 11 11
11 11 11 11 11 11 11 11 11 11 11 11 11 11 11 11 11 11 11 11 11 11 11 11 11 11 11 11 11 11 11 11 11 11 11 11 11 11 11 11 11 11 11 11 11 11 11 11 11 11
