11 11 11 11 11 11 11 11 11 11 11 11 11 11 11 11 11 11 11 11 11 11 11 11 11 11 11 11 11 11 11 11 11 11 11 11 11 11 11 11 11 11 11 11 11 11 11 11 11 11 
11 11 11 11 11 11 11 11 11 12 11 11 11 11 11 12 12 11 12 11 11 11 11 12 12 11 11 11 11 11 11 11 12 12 12 12 11 11 11 11 12 11 11 11 11 11 12 12 11 11 
11 11 12 11 11 11 12 11 11 11 11 12 11 11 11 11 11 11 12 11 11 11 12 11 12 11 12 11 11 12 11 11 11 11 11 11 11 11 11 12 12 11 12 12 11 11 12 11 11 11 
11 11 11 11 11 11 11 11 11 11 11 11 11 11 11 11 11 12 12 11 11 11 11 11 11 11 11 11 11 11 11 11 11 11 11 12 11 11 11 11 12 11 11 11 11 11 12 11 12 11 
11 12 12 11 21 19 19 19 19 19 19 19 19 19 19 19 19 19 19 19 19 19 19 19 19 19 19 19 19 19 19 19 19 19 19 19 19 19 19 19 19 19 19 19 19 22 11 11 12 11
11 11 12 11 17 40 40 40 40 40 40 40 40 40 40 40 40 40 40 40 40 40 40 40 40 40 40 40 40 40 40 40 40 40 40 40 40 40 40 40 40 40 40 40 40 16 11 11 11 11
11 11 11 11 17 40 40 40 40 40 40 40 40 40 40 40 40 40 40 40 40 40 40 40 40 40 40 40 40 40 40 40 40 40 40 40 40 40 40 40 40 40 40 40 40 16 11 11 11 11
11 11 11 11 17 40 40 40 40 40 40 40 40 40 40 40 40 40 40 40 40 40 40 40 40 40 40 40 40 40 40 40 40 40 40 40 40 40 40 40 40 40 40 40 40 16 11 12 11 11
11 11 12 11 17 40 40 10 10 10 10 10 10 10 10 10 10 10 40 10 10 10 10 34 32 35 10 10 10 10 40 10 10 10 10 10 10 10 10 10 10 10 10 40 40 16 11 11 11 11
11 12 12 11 17 40 40 10 10 10 10 10 10 10 10 10 10 10 40 10 10 10 10 30 25 29 10 10 10 10 40 10 10 10 10 10 10 10 10 10 10 10 10 40 40 16 11 12 11 11
11 11 12 11 17 40 40 10 10 10 39 39 10 39 39 10 10 10 40 10 10 10 10 30 25 29 10 10 10 10 40 10 10 10 40 10 10 10 10 40 10 10 10 40 40 16 11 11 11 11
11 12 12 11 17 40 40 10 10 10 39 10 10 10 39 10 10 10 40 10 10 10 10 30 25 29 10 10 10 10 40 10 10 10 10 10 10 10 10 10 10 10 10 40 40 16 12 11 11 11
11 11 11 11 17 40 40 10 10 10 39 10 10 10 39 10 10 10 10 10 10 10 10 30 25 29 10 10 10 10 10 10 10 10 10 10 10 10 10 10 10 10 10 40 40 16 12 11 12 11
11 11 11 12 17 40 40 10 10 10 39 10 44 10 39 10 10 10 10 10 10 10 10 30 25 29 10 10 10 10 10 10 10 10 10 10 10 10 10 10 10 10 10 40 40 16 12 11 12 11
11 11 11 11 17 40 40 10 10 10 39 10 10 10 39 10 10 10 40 10 10 10 10 30 25 29 10 10 10 10 40 10 10 10 10 10 10 10 10 10 10 10 10 40 40 16 11 11 11 11
11 11 11 11 17 40 40 10 10 10 39 39 39 39 39 10 10 10 40 10 10 10 10 30 25 29 10 10 10 10 40 10 10 10 40 10 10 10 10 40 10 10 10 40 40 16 11 11 11 11
11 12 11 11 17 40 40 10 10 10 10 10 10 10 10 10 10 10 40 10 10 10 10 30 25 29 10 10 10 10 40 10 10 10 10 10 10 10 10 10 10 10 10 40 40 16 11 12 11 11
11 11 11 11 17 40 40 10 10 10 10 10 10 10 10 10 10 10 40 10 10 10 10 30 25 29 10 10 10 10 40 10 10 10 10 10 10 10 10 10 10 10 10 40 40 16 11 11 11 11
11 11 11 12 17 40 40 40 40 40 40 40 40 40 40 40 40 40 40 10 10 10 10 30 25 29 10 10 10 10 40 40 40 40 40 40 40 40 40 40 40 40 40 40 40 16 11 11 11 11
11 11 11 12 17 40 40 10 10 10 10 10 10 10 10 10 10 10 40 10 10 10 10 30 25 29 10 10 10 10 40 10 10 10 10 10 10 10 10 10 10 10 10 40 40 16 11 11 12 11
11 12 11 11 17 40 40 10 10 10 10 10 10 10 10 10 10 10 40 10 10 10 10 30 25 29 10 10 10 10 40 10 10 10 10 10 10 10 10 10 10 10 10 40 40 16 11 11 11 11
11 12 12 11 17 40 40 10 10 10 40 10 10 10 40 10 10 10 40 10 10 10 10 30 25 29 10 10 10 10 40 10 10 10 40 10 10 10 10 40 10 10 10 40 40 16 11 11 11 11
11 11 11 11 17 40 40 10 10 10 10 10 10 10 10 10 10 10 40 10 10 10 10 30 25 29 10 10 10 10 40 10 10 10 10 10 10 10 10 10 10 10 10 40 40 16 11 12 12 11
11 11 11 11 17 40 40 10 10 10 10 10 10 10 10 10 10 10 40 10 10 10 10 30 25 29 10 10 10 10 40 10 10 10 10 10 10 10 10 10 10 10 10 40 40 16 11 11 12 11
11 11 11 11 17 40 40 10 10 10 10 10 10 10 10 10 10 10 10 10 10 10 10 30 25 29 10 10 10 10 10 10 10 10 10 10 10 10 10 10 10 10 10 40 40 16 11 11 12 11
11 12 12 11 17 40 40 10 10 10 10 10 10 10 10 10 10 10 40 10 10 10 10 30 25 29 10 10 10 10 40 10 10 10 10 10 10 10 10 10 10 10 10 40 40 16 11 12 11 11
11 12 11 11 17 40 40 10 10 10 10 10 10 10 10 10 10 10 40 10 10 10 10 30 25 29 10 10 10 10 40 10 10 10 10 10 10 10 10 10 10 10 10 40 40 16 12 11 11 11
11 12 11 11 17 40 40 10 10 10 40 10 10 10 40 10 10 10 40 10 10 10 10 30 25 29 10 10 10 10 40 10 10 10 40 10 10 10 10 40 10 10 10 40 40 16 12 12 11 11
11 11 12 11 17 40 40 10 10 10 10 10 10 10 10 10 10 10 40 10 10 10 10 30 25 29 10 10 10 10 40 10 10 10 10 10 10 10 10 10 10 10 10 40 40 16 11 12 11 11
11 11 12 11 17 40 40 10 10 10 10 10 10 10 10 10 10 10 40 10 10 10 10 30 25 29 10 10 10 10 40 10 10 10 10 10 10 10 10 10 10 10 10 40 40 16 11 12 12 11
11 11 12 11 17 40 40 40 40 40 40 40 40 40 40 40 40 40 40 10 10 10 10 30 25 29 10 10 10 10 40 40 40 40 40 40 40 40 40 40 40 40 40 40 40 16 11 11 11 11
11 11 11 11 17 40 40 40 10 10 10 10 10 10 10 10 40 40 40 10 10 10 10 30 25 29 10 10 10 10 40 10 10 10 10 10 10 10 10 10 10 10 10 40 40 16 11 11 11 11
11 11 11 11 17 40 40 10 10 10 10 10 10 40 10 10 10 10 40 10 10 10 10 30 25 29 10 10 10 10 40 10 10 10 10 10 10 10 10 10 10 10 10 40 40 16 11 11 11 11
11 11 11 11 17 40 40 10 40 40 10 10 10 40 40 10 10 10 40 10 10 10 10 30 25 29 10 10 10 10 40 10 10 10 10 10 10 10 10 10 10 10 10 40 40 16 11 11 11 11
11 11 11 12 17 40 40 10 10 10 10 10 10 10 10 10 40 10 40 10 10 10 10 30 25 29 10 10 10 10 40 10 10 10 13 14 14 14 14 15 10 10 10 40 40 16 11 11 11 11
11 11 11 11 17 40 40 10 10 40 10 10 10 10 10 10 10 10 40 10 10 10 10 30 25 29 10 10 10 10 40 10 10 10 16 11 11 11 11 17 10 10 10 40 40 16 11 11 11 12
11 12 11 11 17 40 40 10 10 10 10 10 41 10 10 10 10 10 10 10 10 10 10 30 25 29 10 10 10 10 10 10 10 10 16 11 11 12 12 17 10 10 10 40 40 16 11 11 12 12
11 11 11 11 17 40 40 10 40 10 10 10 10 10 10 10 10 10 40 10 10 10 10 30 25 29 10 10 10 10 40 10 10 10 16 11 11 11 11 17 10 10 10 40 40 16 11 12 12 11
11 11 11 11 17 40 40 10 10 10 10 10 40 10 10 10 40 10 40 10 10 10 10 30 25 29 10 10 10 10 40 10 10 10 18 19 19 19 19 20 10 10 10 40 40 16 12 11 11 11
11 11 11 11 17 40 40 10 10 10 10 10 10 10 10 10 40 10 40 10 10 10 10 30 25 29 10 10 10 10 40 10 10 10 10 10 10 10 10 10 10 10 10 40 40 16 12 11 11 11
11 12 11 11 17 40 40 10 10 10 40 10 10 10 10 10 10 10 40 10 10 10 10 30 25 29 10 10 10 10 40 10 10 10 10 10 10 10 10 10 10 10 10 40 40 16 11 11 11 11
11 12 11 11 17 40 40 10 10 10 10 10 10 10 10 10 10 10 40 10 10 10 10 36 27 37 10 10 10 10 40 10 10 10 10 10 10 10 10 10 10 10 10 40 40 16 11 11 12 11
11 11 12 11 17 40 40 40 40 40 40 40 40 40 40 40 40 40 40 40 40 40 40 40 40 40 40 40 40 40 40 40 40 40 40 40 40 40 40 40 40 40 40 40 40 16 11 11 11 11
11 11 12 12 17 40 40 40 40 40 40 40 40 40 40 40 40 40 40 40 40 40 40 40 40 40 40 40 40 40 40 40 40 40 40 40 40 40 40 40 40 40 40 40 40 16 11 11 11 11
11 11 12 11 17 40 40 40 40 40 40 40 40 40 40 40 40 40 40 40 40 40 40 40 40 40 40 40 40 40 40 40 40 40 40 40 40 40 40 40 40 40 40 40 40 16 11 11 12 11
11 12 12 11 23 14 14 14 14 14 14 14 14 14 14 14 14 14 14 14 14 14 14 14 14 14 14 14 14 14 14 14 14 14 14 14 14 14 14 14 14 14 14 14 14 24 11 11 11 11
11 11 11 11 11 11 11 11 11 11 11 11 11 11 11 11 12 12 11 11 11 11 12 11 11 11 11 12 12 11 11 11 11 11 11 11 11 11 11 11 11 11 11 11 11 11 11 11 11 11 
11 11 11 11 11 11 11 11 11 11 12 11 11 11 11 11 11 12 11 11 11 11 11 11 11 11 12 11 11 11 11 11 11 11 11 11 11 11 12 11 11 11 11 12 11 11 11 12 11 11 
11 11 12 11 11 11 12 12 11 11 11 11 11 11 11 11 11 11 11 11 12 11 11 12 11 11 12 11 11 11 11 11 11 11 11 11 11 11 11 11 11 11 11 11 12 11 11 11 11 11 
11 11 11 11 11 11 11 11 11 11 11 11 11 11 11 11 11 11 11 11 11 11 11 11 11 11 11 11 11 11 11 11 11 11 11 11 11 11 11 11 11 11 11 11 11 11 11 11 11 11 
